########xx#######
#...............#
#...............#
#...............#
#...............x
#...............x
#...............#
#################
