#################
#...............#
#...............#
#................
#................
#...............#
#...............#
#################

