{

"map": [
[
".................",
".................",
".................",
".................",
".................",
".................",
".................",
".................",
".................",
".................",
"................."],

[
"#################",
"#               #",
"#           t   #",
"#               #",
"#               #",
"#               #",
"#                ",
"#                ",
"#  t            #",
"#               #",
"#################"]
],

"items": [{"name": "mine", "symbol": "i" , "model": "model/mine.json", "pos": [2,2]}],

"enemies": [{"name" : "enemy", "file": "char/EvilJackson", "pos": [5,5], "symbol" : "e"}]

}
