########..#######
#...............#
#...............#
#...............#
.................
.................
#...............#
#######.#########

