{

"map": [
"#################",
"#...............#",
"#...............#",
"#................",
"#................",
"#...............#",
"#...............#",
"#################"
]

}