{

"map": [
[
".................",
".................",
".................",
".................",
".................",
".................",
".................",
".................",
".................",
".................",
"................."],

[
"ooooooooooooooooo",
"o               o",
"o           t   o",
"o               o",
"o               o",
"o               o",
"o                ",
"o                ",
"o  t            o",
"o               o",
"ooooooooooooooooo"]
],

"items": [

	{"name": "mine" , "pos": [2,2] } ,
	{"name" : "sword", "pos" : [5,2] }
],

"enemies": [
	{"name" : "EvilJackson" , "pos": [5,5] } ]
}

