{

"map": [
[
".................",
".................",
".................",
".................",
".................",
".................",
".................",
".................",
".................",
".................",
"................."],

[
"#################",
"#          b  ###",
"#          b    #",
"#          b    #",
"#      #######  #",
"#            #  #",
"             #  #",
"             #  #",
"#            #  #",
"#            #  #",
"##############  #"]
]

}
