{

"map": [
[
".................",
".................",
".................",
".................",
".................",
".................",
".................",
".................",
".................",
".................",
"................."],

[
"ooooooooooooooooo",
"o          b  ooo",
"o          b    o",
"o          b    o",
"o      ooooooo  o",
"o            o  o",
"             o  o",
"             o  o",
"o            o  o",
"o            o  o",
"oooooooooooooo  o"]
]

}

