#################
#...............#
#.......###.....#
#.......#.#.....#
###..####.####..#
#............#..#
#............#..#
##########..##..#