{

"map": [
[
".................",
".................",
".................",
".................",
".................",
".................",
".................",
"................."],

[
"#################",
"#          ######",
"#               #",
"                #",
"       #######  #",
"#            #  #",
"#            #  #",
"##############  #"]
]

}