#################
#..........######
#...............#
................#
.......#######..#
#............#..#
#............#..#
##############..#

