{

"map": [
[
".................",
".................",
".................",
".................",
".................",
".................",
".................",
"................."],

[
"#################",
"#           #####",
"#          b    #",
"           b    #",
"       #######  #",
"#            #  #",
"#            #  #",
"##############  #"]
]

}
