{

"map": [
"#################",
"#..........######",
"#...............#",
"................#",
".......#######..#",
"#............#..#",
"#............#..#",
"##############..#"
]

}