{

"map": [
[
".................",
".................",
".................",
".................",
".................",
".................",
".................",
".................",
".................",
".................",
"................."],

[
"                 ",
"                 ",
"                 ",
"                 ",
"                 ",
"                 ",
"                 ",
"                 ",
"                 ",
"                 ",
"                 "]

],

"items": [

],

"enemies": [ ]

}

