.################
#...............#
#................
#........#......#
###..####.####..#
#............#..#
#............#..#
##########..##..#

