{

"var" : {

"clean_ground" : [
".................",
".................",
".................",
".................",
".................",
".................",
".................",
".................",
".................",
".................",
"................."
]

},


"1" : {

"map" :  [

[
".................",
".................",
".................",
".................",
".................",
".................",
".................",
".................",
".................",
".................",
"................."
],

[
"ooo  oooooooooooo",
"o               o",
"o  oooo         o",
"o          ooo  o",
"ooooooo         o",
"o     b         o",
"      oooooob  oo",
"      b         o",
"ol     b         ",
"oll     blll    o",
"ooooooooooooooooo"]

],

"items": [ ],

"enemies": [
	{"name" : "EvilJackson" , "pos": [5,9] },
	{"name" : "EvilJackson" , "pos": [10,2] },
	{"name" : "EvilJackson" , "pos": [12,5] }
]

},

"2" : {

"map" :  [

[
".................",
".................",
".................",
".................",
".................",
".................",
".................",
".................",
".................",
".................",
"................."
],

[
"o  oooooooooooooo",
"o  b            o",
"o  oooooobbooobbo",
"o  o   b     o  o",
"o  o   b     b   ",
"o  b   o     b   ",
"o  b   o     b   ",
"obboobbooooooobbo",
"   b         b  o",
"   b         b  o",
"ooooooooooooooooo"]

],

"items": [ ],

"enemies": [

]

}


}

